XXXXXXXXXX
XD  O    X
X  XxxxXXX
X        X
X        X
X        A
XXXXXXXXXX