XXXXXXXXXX
XD  O    X
X  XxxxXXX
X        X
X   XXXXXX
X        A
XXXXXXXXXX