XDXXXXXXXX
X        X
X   xxxxXX
X        X
X   XXXXXX
X        A
XXXXXXXXXX