XXXXXXXXXX
X  O     X
X D xxxXXX
X        X
X   XXXXXX
X        A
XXXXXXXXXX