#D########
#        #
# ########
#   #    #
#   ###  #
#        A
##########