XDXXXXXXXX
X  O     X
X  XxxxXXX
X        X
X   XXXXXX
X        A
XXXXXXXXXX