#D########
#        #
#   ######
#        #
#   ######
#        A
##########