XDXXXXXXXX
X  O     X
X   xxxxXX
X      O X
X   XXXXXX
X        A
XXXXXXXXXX