#D########
#        #
# ########
#   #    #
#   #    #
#        A
##########